A_Bassik_gscan	CRISPRa	growth
D_Bassik_gscan	CRISPRd	growth
I_Bassik_gscan	CRISPRi	growth
K_Bassik_gscan	CRISPRk	growth
CAPRIN1_HCRFF	CRISPRi	HCRFF
CAT_HCRFF	CRISPRi	HCRFF
CD164_HCRFF	CRISPRi	HCRFF
ERP29_HCRFF	CRISPRi	HCRFF
FADS1_HCRFF	CRISPRi	HCRFF
FADS2_HCRFF	CRISPRi	HCRFF
FADS3_HCRFF	CRISPRi	HCRFF
FEN1_HCRFF	CRISPRi	HCRFF
GATA1_HCRFF	CRISPRi	HCRFF
HBE1_HCRFF	CRISPRi	HCRFF
HBG1_HCRFF	CRISPRi	HCRFF
HBG2_HCRFF	CRISPRi	HCRFF
HBS1L_HCRFF	CRISPRi	HCRFF
HDAC6_HCRFF	CRISPRi	HCRFF
LMO2_HCRFF	CRISPRi	HCRFF
MEF2C_HCRFF	CRISPRi	HCRFF
MYB_HCRFF	CRISPRi	HCRFF
MYC_HCRFF	CRISPRi	HCRFF
NMU_HCRFF	CRISPRi	HCRFF
PVT1_HCRFF	CRISPRi	HCRFF
